
NO images/wallA.png
SO images/wallD.png
WE images/wallB.png

EA images/wallC.png

F 49,50,51
C 17,18,20


11111111111111111111
10000000000000000001          
101111111111111111011111111111111
101              10000000000000K1
101              11111111111111D1
101     1111111111111111111111101111
101     1000000000000000000000000001
101     1011111110111111111111011111
101     101     101          101
1011111110111111101         11011
1000000000000000001         100B1
1111111111111111111         100B1
                        11111000111111
              1111111111100B0000000001
              10X000000VD0W00000000001
              111111111110000000000BB1
                        11111111111111

