



NO images/wallA.png


SO images/wallD.png eea
WE               images/wallB.png                


EA images/wallC.png

F 51,0,0
C images/roof.png


11111111111111111111
10000000000000000001          
101111110111111111011111111111111
1011100000000000010000000000000K1
101B01000BBBBB00011111111111111D1
101B000011111111110B00000BBB00101111
100000000000000000000000000000000001
101BB001101111111B111111111111011111
101BBB11111     111          101
11111111111                 11011
                            100B1
                            100B1
                        11111000111111
                   11111100B0000000001
                   1X00VD0W001BB100001
                   1111110000000000BB1
                        11111111111111
