NO images/aN.png
SO images/aS.png
WE images/aW.png

EA images/aE.png

F 255,1,1
C 1,255,1


11111111111111111111111111111111111111111111111111111111111111
10000000000000000000000000000000000000000000000000000000000001
10000000000000000000000000000000000000000000000000000000000001
10001100000000000000000000000000000000001100000000000000000001
10001100000000000000000000000000000000001100000000000000000001
10001100000000000000000000000000000000001100000110000000000001
10001100000000000000000000000W00000000001100000110000000000001
10001100000000000000000000000000000000001100000110000000000001
10001100000000000000000000000000000000001100000110000000000001
10001100000000000000000000000000000000001100000110000000000001
10000000000000000000000000000000000000000000000000000000000001
10000000000000000000000000000000000000000000000000000000000001
10000000000000000000000000000000000000000000000000000000000001
10000000000000000000000000000000000000000000000000000000000001
10000000000000000000000000000000000000000000000000000000000001
10001100000110000000000000000000000000110000000000000000000001
10001100000110000000000000000000000000110000000000000000000001
10001100000110000000000000000000000000110000000000000000000001
10001100000110000000000000000000000000110000000000000000000001
10001100000110000000000000000000000000110000000000000000000001
10001100000110000000000000000000000000110000000000000000000001
10001100000110000000000000000000000000111111111111110000000001
10001100000110000000000000000000000000111111111111110000000001
10000000000000000000000000000000000000000000000000000000000001
10000000000000000000000000000000000000000000000000000000000001
11111111111111111111111111111111111111111111111111111111111111