
NO images/test.png
SO images/testB.png
WE images/testC.png

EA images/testD.png

F 97,90,72
C 33,28,15


11111111111111111111                       
10000000000000000001                    
101111111111111111011111111111111       
101              1000000000000001                
101              1111111111101111     
101     1111111111111111111101111111
101     10000000000W0000000000000001
101     1011111110111111111111011111    
101     101     101          101          
1011111110111111101         11011          
1000000000000000001         10001          
1111111111111111111         10001        
                        11111000111111
                        10000000000001
                        10000000000001
                        10000000000001
                        11111111111111

