
NO images/wallA.png
SO images/wallD.png
WE images/wallB.png

EA images/wallC.png

F 31,20,18
C images/roof.png

   111
1111X1111
1VD000BB111111
10B000BB10001
1000000010K01
1000N00000001
1111111111111
