
NO images/wallA.png
SO images/wallD.png
WE images/wallB.png

EA images/wallC.png

F 31,20,18
C images/roof.png

   111
1111X1111
10D0V0BB1
10B0K0BB1
100000001
1000N0001
111111111
