
NO images/wallA.png
SO images/wallD.png
WE images/wallB.png

EA images/wallC.png

F images/floor.png
C images/roof.png

   111
1111X1111
10D0V0001
10B0K0B01
100000001
1000N0001
111111111
