NO images/wallA.png
SO images/wallD.png
WE images/wallB.png
EA images/wallC.png
F 49,50,51
C 17,18,20
        1111111111111111111111111
        100K000000110000000000001
        1111000001110000000000001
        10X1000000000000000000001
111111111011000001110000000000001
10000000DV11000001110111111111111
11D1D111111111011100000010001	
11010111111111D11101010010001
11000000110101011100000010001
10000000000000001100000010001
100000000000000011010100100011
11000001110101011100011000N0011
11110111 1110101 1011110100011
11111111 1111111 111111111111

