NO images/wallA.png
SO images/wallD.png
WE images/wallB.png
EA images/chibrepoilu.png

F 49,50,51
C 17,18,20


        1111111111111111111111111
        1000000000110000000000001
        1011000001110000000000001
        1001000000000000000000001
111111111011000001110000000000001
100000000011000001110111111111111
11110111111111011100000010001
11110111111111011101010010001
11000000110101011100000010001
10000000000000001100000010001
100000000000000011010100100011
11000001110101011100011000N0011
11110111 1110101 1011110100011
11111111 1111111 111111111111



